YUMÉ | À PARTIR DE 6 ANS | auditorium de Seynod
AURORES/ORCHESTRE PAYS DE SAVOIE | CONCERT | grande salle
MARILYN, MA GRAND-MÈRE ET MOI | petite salle
HABITER LE TEMPS | À PARTIR DE 15 ANS | grande salle
OLIVIA RUIZ | CONCERT-SPECTACLE | grande salle | tarif spécial
VOCATION | petite salle
OUTWITTING THE DEVIL | grande salle
PHILIPPE BIANCONI | CONCERT | Musée-château
CRISTAUX | salle de création G. Monnet
MACEO PARKER | CONCERT | arcadium | tarif spécial
LES FRÈRES KARAMAZOV | À PARTIR DE 14 ANS | grande salle
GISELLE... | petite salle
MÉLISSA LAVEAUX | grande salle
LES FABLES | À PARTIR DE 8 ANS | petite salle
DÉSORDRE DU DISCOURS | À PARTIR DE 13 ANS | IUT d'Annecy-le-Vieux
ENCORE LA VIE | À PARTIR DE 6 ANS | grande salle
L'ÉCORCE DES RÊVES | À PARTIR DE 3 ANS | salle de création G. Monnet
WO-MAN ET POINT ZÉRO | À PARTIR DE 10 ANS | petite salle
ALEX LUTZ | grande salle | tarif spécial
FIESTA LATINA | grande salle | tarif A+
LE PÉRIMÈTRE DE DENVER | À PARTIR DE 14 ANS | grande salle
LAURA | À PARTIR DE 8 ANS | petite salle
TUMULUS | CRÉATION | grande salle
JE VOUS AI PRÉPARÉ UN BIO TRUC | À PARTIR DE 13 ANS | petite salle
BACHAR MAR-KHALIFÉ | CONCERT-SPECTACLE | grande salle | tarif A+
LA DISPARITION DU PAYSAGE | À PARTIR DE 13 ANS | grande salle
DÉSOBÉIR | petite salle
SAMSARA | À PARTIR DE 8 ANS | grande salle
RÉSISTE | À PARTIR DE 8 ANS | petite salle
CORPS EXTRÊMES | CRÉATION | À PARTIR DE 10 ANS | grande salle
